##################
#P          #    #
#                #
#          T     #
#                #
##################
#p          #    #
#                #
#          t     #
#                #
##################