##################
#P          #    #
#                #
#          T     #
##               #
#p    x     #    #
#     x          #
#                #
#         t#     #
##################