##################
#P          #    #
#                #
#    T     %     #
#               ##
#p          #    #
#                #
#                #
#          #t    #
##################