#####################
###              T###
###               ###
###               ###
###  p    #  #    ###
###       ## ##   ###
###       #####   ###
###       # # #   ###
###       #####   ###
###               ###
###       #####   ###
###       #####   ###
###      ######   ###
###%     ######   ###
###   ## ######   ###
###   # t######   ###
###   #########   ###
###               ###
###        P      ###
#####################
#                   #
# # # ### ## ## # # #
# ### # # ## ##  #  #
# # # ### #  #   #  #
#                   #
#####################