###########
###T#######
##x xxxxxx#
#         #
#p%      P#
#        t#
#% %      #
#xxxxxxxxx#
###########