###########
### T######
##x %xxxxx#
#         #
#p%      P#
#        t#
#% %      #
#xxxxxxxxx#
###########