##########
#tx   T  #
#        #
#P   #   #
#p    #  #
#        #
#     %  #
##########