###########
#  %t#x   #
#   ##   x#
#   ##   ##
#   %%    #
#   ##    #
#P# T#   p#
###########