##############################################################################
#         T                                                                  #
##                                                                          %#
#     ###    ####### ######  ### ####### #######  #####  #     #    ###      #
#    #       #       #     #  #     #    #       #     # #     #       #     #
#    #       #  p    #     #  #     #    #       #       #     #       #     #
#   ##       #####   ######   #     #    #####   #       #######       ##    #
#    #       #       #        #     #    #       #       #     #       #    %#
#    #       #       #        #     #    #       #     # #     #     P #  t %#
#     ###    ####### #       ###    #    #######  #####  #     #    ### %    #
#                                                                            #
#                                                                          % #
##############################################################################