################
#T   #       #t#
#            # #
# #            #
#x   %        %#
#x%            #
##P           p#
################