#####################################################
#                                                   #
#                                                   #
#                                                   #
#   #  T  #                                         #
#    #   #   ####  #    #    #    #  ####  #    #   #
#     # #   #    # #    #    #    # #    # ##   #   #
#      #    #    # #    #    #  t # #    # # #  #   #
#      #    #    # #    #    # ## # #    # #  # #   #
#      #    # P  # #    #    ##  ## # p  # #   ##   #
#      #     ####   ####     #    #  ####  #    #   #
#                                                   #
#                                                   #
#####################################################